1111111111111
1P001C1000001
1000101000E01
100C000001001
1C000000110C1
1111111111111