11111111111111111111
10000000011111000011
11100100C00001000001
10100000101101000001
101111111C0101000001
10100000000101000001
11000001000101111111
10000000000100000001
1011111110C101000001
10100P1C0E0101000001
10001111100101111111
10000000001000000111
11111111111111111111