1111111111111
1001110000001
1001P10000E01
1001110111001
1C000000110C1
1111111111111