1111111111111
100P111000001
1000101000E01
1011000001101
110000C011011
1111111111111