11111111111111111111111111
10000C000000110000C0000001
10000000000011000000000001
100110000E0011001100000001
100110000C001100110000C001
10000000000000000000000001
100000P0000000000000000001
100C000111001100C000111001
1C000000110C11C000000110C1
1C000000110C11C000000110C1
10000C000000110000C0000001
10000000000011000000000001
10011000000011001100000001
100110000C001100110000C001
10000000000011000000000001
10000000000011000000000001
100C000111001100C000111001
1C000000110C00C000000110C1
11111111111111111111111111