1111111111111
1011110000001
1P10C00000001
1010101000001
10101010000E1
1010101000001
1000101000001
1111111111111