11111111111111111111111111110111111111111111111111111111
10000C000000110000C0000001111111111111111111111111111111
10000000000011000000000001111111111111111111111111111111
10011000000011001100000001111111111111111111111111111111
100110000C001100110000C001111111111111111111111111111111
100110000000110011000000000000000000001P0000000000111111
100110000C001100110000C001000000000000111000000000111111
10000000000011000000000001000000000000000000000000111111
10000000000011000000000001000000000000000000000000111111
100C000111001100C000111001000000000000000000000000111111
1C000000110C00C000001E00C1000000000000000000000000111111
1C000000110C00C000001110C1000000000000000000000000111111
1C000000110C00C000000110C1000000000000000000000000111111
1C000000110C00C000000110C1000000000000000000000000111111
1C000000110C00C000000110C1000000000000000000000000111111
1C000000110C00C000000110C1000000000000000000000000111111
1C000000110C00C000000110C1000000000000000000000000111111
1C000000110C00C000000110C1000000000000000000000000111111
1C000000110C00C000000110C1000000000000000000000000111111
11111111111111111111111111111111111111111111111111111111