1111111
1P001C1
1110C01
110C001
1CE1011
1111111