11111111111111111111
10000000011111000011
11100100000001000001
10100000101101000001
10111111100101000001
10100000000101000001
11000000000101111111
10000000000100000001
10111111100101000001
10100P0C0E0101000001
10000000000101111111
10000000000100000011
11111111111111111111