1111111
10100C1
1010101
10P0101
11111E1