11111111111111111111
10000000C11111000011
11100100000001000001
10100000111101000001
10111111100101000001
10100000000101000001
11000000000101111111
100000000001000000E1
10111111100101000001
10100000000101000001
10P00000000101111111
10000000000100000011
11111111111111111111