11111111111111111111
1P000000011111000001
11100000000001000001
10100000111101000001
10111111100101000001
10100000000101000001
10000000000101111111
100000000001000000E1
11111111111111111111