111111111111
1PE001CCCCC1
111111111111